0000000000000000000
1111111111111111111
1...11.......11...1
1s1....11111....1s1
1.1.11...1...11.1.1
1....1.1.1.1.1....1
1.11.1.1...1.1.11.1
1..1.1.11111.1.1..1
11.1.....b.....1.11
11.1.1.11R11.1.1.11
11...1.1bbb1.1...11
11.1.1.11111.1.1.11
11...............11
11.11111.1.11111.11
...1.....1.....1...
11.1.1.11111.1.1.11
1....1.......1....1
1s11.111.1.111.11s1
1.1......1......1.1
1.1.11.11111.11.1.1
1........P........1
1111111111111111111
0000000000000000000